0033203232203112
2222033132331232
3200030321212221
0222122201012122
3201111333333333
3230333232021012
2103012000103030
2120220013310210

